{
    "comment": [
        "s: start",
        "t: ゴール",
        "p: 回復薬",
        "e: enemy(goblin)",
        "k: ドアの鍵",
        "d: 鍵付きドア",
        "0: 何もない",
        "w: 壁"
    ],
    "stage_data": [
        {
            "name": "stage1-1",
            "maze_size": 200,
            "level": "easy",
            "maze": [
                "w,w,w,w,w,w,w,w,w,w,w,w,w,w,w,w,w,w,w,w",
                "w,0,0,0,w,0,0,0,0,0,0,0,0,0,0,0,0,0,p,w",
                "w,0,t,0,w,0,0,0,0,0,0,0,0,0,0,0,e,0,0,w",
                "w,0,0,0,w,0,0,0,0,0,w,0,0,w,0,w,w,w,w,w",
                "w,w,d,w,w,0,0,0,0,0,w,0,0,w,0,w,0,s,0,w",
                "w,0,0,0,0,0,0,e,0,0,w,0,0,w,0,w,0,0,0,w",
                "w,0,0,0,0,0,0,0,0,0,w,0,0,w,k,w,0,0,0,w",
                "w,w,w,w,w,w,w,w,0,0,w,0,0,w,w,w,0,0,0,w",
                "w,p,0,e,0,0,0,0,0,0,w,0,0,0,0,0,0,0,0,w",
                "w,w,w,w,w,w,w,w,w,w,w,w,w,w,w,w,w,w,w,w"
            ]
        },
        {
            "name": "stage1-2",
            "maze_size": 200,
            "level": "easy",
            "maze": [
                "w,w,w,w,w,w,w,w,w,w,w,w,w,w,w,w,w,w,w,w",
                "w,0,0,0,w,0,0,0,0,0,0,0,0,0,0,0,0,0,p,w",
                "w,0,s,0,w,0,0,0,e,0,0,0,0,0,0,0,e,0,0,w",
                "w,0,0,0,w,0,0,0,0,0,w,0,0,w,0,w,w,w,w,w",
                "w,w,d,w,w,0,0,0,0,0,w,0,0,w,0,w,0,t,0,w",
                "w,0,0,0,0,0,0,e,0,0,w,0,0,w,0,w,0,0,0,w",
                "w,0,0,0,0,0,0,0,0,0,w,0,0,w,k,w,0,e,0,w",
                "w,w,w,w,w,w,w,w,0,0,w,0,0,w,w,w,0,0,0,w",
                "w,p,0,e,0,0,0,0,0,0,w,0,0,0,0,0,0,0,0,w",
                "w,w,w,w,w,w,w,w,w,w,w,w,w,w,w,w,w,w,w,w"
            ]
        }
    ]
}